999999999999999999999999999-
999999999999999999999999999-
000100000010001000000100099-
666667666766620000000000099-
001000100000036662000000099-
956666620000000003666500099-
980010036666620000000800099-
980001000000036666666400099-
980100000010000001001000099-
936666666666666666662000099-
900000100010000100008000099-
900566666666666666664000099-
900800100000000010000000099-
990800999999999999999999999-
990809999999999999999999999